000000000000000000000000000000
000000000000000000000000000000
000000000000000000000000000000
000000000000000000000000000000
000000032224000000000000000000
000000000000000000000000000000
340000000000000003400000034000
512222222222222221600003211400
511111111111111111600005111600
511111111111111111600000560000
511111111111111111600000500000
511111111111111111600000500000
511111111111111111600000000000